000000000000000000000000000000000000000000000000000000000000
000000000000000000000000000000000000000000000000000000000000
000000000000000000000000000000000000000000000000000000000000
000000000000000000000000000000000000000000000000000000000000
0000000222220000000000000000000000000r0000000000000000000000
00000000l000000000000000000000000000000000000000000000000000
220000000000000002200000022000222222222222222222222222222222
112222222222222221100002211200111111111111111111111111111111
111111111111111111100001111100111111111111111111111111111111
111111111111111111100000110000111111111111111111111111111111
111111111111111111100000100000111111111111111111111111111111
111111111111111111100000100000111111111111111111111111111111
111111111111111111100000000000111111111111111111111111111111