3000000000000000000000000000000000000000000000000000000000000000000000000000000000000000000000000000000000000000000000
3000000000000000000000000000000000000000000000000000000000000000000000000000000000000000000000000000000000000000000000
3000000000000000000000000000000000000000000000000000000000000000000000000000000000000000000000000000000000000000000000
3000000000000000000000000000000000000000000000000000000000000000000000000000000000000000000000000000000000000000000000
30000000c0000000000000000000000000000000000000000000002222200020000000000000000000000000000000000000000000000000000000
30000000000d0000000000000000000000000000000020000022220000000002222220000000000000000000000000000000000000000000000000
3000000022222000000000000000000000000000000002222200000000000000000000000000000000000000000000000000000000000000000000
300000j00000000000s0000000000000000000e00000000000000000000000000000000000000000000000000000000000000000000000000e0000
3220j000uB00000l002200000022000222222222222222222222222222222222222222222222222222222222222222222222222222222222222222
3112222222222222221100002211200111111111111111111111111111111111111111111111111111111111111111111111111111111110011111
3111111111111111111100001111100111111111111111111111111111111111111111111111111111111111111111111111111111111111011111
3111111111111111111100000110000111111111111111111111111111111111111111111111111111111111111111111111111111111111011111
3111111111111111111100000100000111111111111111111111111111111111111111111111111111111111111111111111111111111111011111
3111111111111111111100000100000111111111111111111111111111111111111111111111111111111111111111111111111111111111011111

