30000000000000000000000000000000000000000000000000000000000000000000000000000000000000000000000000000000000000000
30000000000000000000000000000000000000000000000000000000000000000000000000000000000000000000000000000000000000000
30000000000000000000000000000000000000000000000000000000000000000000000000000000000000000000000000000000000000000
30000000000000000000000000000000000000000000000000000000000000000000000000000000000000000000000000000000000000000
30000000c00000000000000000000000000000000000000000000022222000200000000000000000000000000000000000000000000000000
30000000000000000000000000000000000000000000200000222200000000022222200000000000000000000000000000000000000000000
30000000222220000000000000000000000000000000022222000000000000000000000000000000000000000000000000000000000000000
300000j000000000000000000000000000000000000000000000000000000000000000ttttttttttttttttttttttttttttttttttttttttttt
3220j00000e0000l0022000000220002222222222222222222222222222222222222222222222222222222222222222222222222220000000
31122222222222222211000022112001111111111111111111111111111111111111111111111111111111111111111111111111111111100
31111111111111111111000011111001111111111111111111111111111111111111111111111111111111111111111111111111111111110
31111111111111111111000001100001111111111111111111111111111111111111111111111111111111111111111111111111111111110
31111111111111111111000001000001111111111111111111111111111111111111111111111111111111111111111111111111111111110
31111111111111111111000001000001111111111111111111111111111111111111111111111111111111111111111111111111111111110

