3000000000000000000000000000000000000000000000000000000000000000000000000000000000000000000000000000000000000003
30000c0000l000d0000000000000000000000000000000000000000d00000000000000000000000000000000000000000000000000000003
3222222222222222222222222222222222222222222222200002222222222222222222222222222222222222222222222222222222222223
3000000020000002000000000000000000000000000000000003020000000000200000000000000000000000000000000000000000000003
3d00000u2d000002000000000000000000000000000u000000030200000d0000200000000000000000000000000000000000000000000003
3222222222222222222222222222222222222222222222200002222222222222222222222222222222222222222222222222222222222223
3000000200000000000000000000000000000000200000300003020000000000200000000000000000000000000000000000000000000003
300000u2000000000000c0000u00000l00l00l0020000030000302000000000d20000000000000000000000000000000c00000s000000e03
3222222222222222222222222222222222222222222222200002222222222222222222222222222222222222222222222222222222222223
3111111111111111111111111111111111111111111111100001111111111110000000000000000000000000011111111111111111111113
311111111111111111111111111111111111111111111110000111111111111000000000u0000l0000l0000l011111111111111111111113
3111111111111111111111111111111111111111111111100001111111111111111111111111111111111111111111111111111111111113
3111111111111111111111111111111111111111111111100001111111111111111111111111111111111111111111111111111111111113
3111111111111111111111111111111111111111111111100001111111111111111111111111111111111111111111111111111111111113
