3000000000000000000000000000000000000000000000000000000000000000000000000000000000000000000000000000000000000003
3000000000000000000000000000002000000000000000000000000000000000000000000000000000000000000000000000000000000003
300l000000l000000000000l00cj0020000000000000000000000000000000000l0l00000000000000000000000000000000000000000003
3222222222222222222222222222002000000000000000000000000000000022222222000000000000000000000000000000000000000003
3000000000000000000000000000002000000000000000000000000000000c00000000000000c00000000000000000000000000000000003
3000000000000000000000000000002000000000000000000000000000000000000000000000000000000000000000000000000000000003
3000000000000000000000000000002000000000000000000000000000000000000000000000000000000000000000000000000000000003
3000000000l000000l00000l00000j20s000000000l0000l0000l00000j0000000000000000j0000000000000l0000l00l00l00l000e0003
3222222222222222222222222222222222222222222222222222222222222222222222222222000000022222222222222222222222222223
3111111111111111111111111111111111111111111111111111111111111111111111111111000000211111111111111111111111111113
3111111111111111111111111111111111111111111111111111111111111111111111111111000000011111111111111111111111111113
3111111111111111111111111111111111111111111111111111111111111111111111111111000000011111111111111111111111111113
3111111111111111111111111111111111111111111111111111111111111111111111111111000000011111111111111111111111111113
3111111111111111111111111111111111111111111111111111111111111111111111111111000000011111111111111111111111111113