3000000000000000000000000000000000000000000000000000000000000000000000000000000000000000000000000000000000000003
3000000000000000000000000000000000000000000000000000000000000000000000000000000000000000000000000000000000000003
3000000000000000000000000000000000000000000000000000000000000000000000000000000000000000000000000000000000000003
3000c00000000000000000000000000000000000000000000000000000000000000000000000000000000000000000000000000000000003
300000000000000000000000000000000dt00000000000000000000000000000000000000000000000000000000000000000000000000003
3002222000000000000000000000000022222000000000000022222200000000000000000000000000000000000000000000000000000003
3000000000000000000000000000000000000000000000000000000000000000000000000000000000000000000000000000000000000003
3000u00t000t0j0000000000000000j0000t000000000000000u0000000000t00t00000000000000jt0000000000000t000000t0000e0003
32222222222222000000000c2222222222222222222222222222000000022222222222222222222222000002222222222222222222222223
311111111111110000j000021111111111111111111111111111000000011111111111111111111111000021111111111111111111111113
3111111111111100000000011111111111111111111111111111000000011111111111111111111111000011111111111111111111111113
3111111111111100000000011111111111111111111111111111000000011111111111111111111111000011111111111111111111111113
3111111111111100000000011111111111111111111111111111000000011111111111111111111111000011111111111111111111111113
3111111111111100000000011111111111111111111111111111000000011111111111111111111111000011111111111111111111111113
