3000000000000000000000000000003
3000000000000000000000000000003
3000000001110000111100000000003
3000000000000000000000000000003
3000s0d0000000B0000000d00s00003
3000111000000000000000111100003
3000000000000000000000000000003
30000u0000j000000000j000u000003
3222222222222222222222222222223
3111111111111111111111111111113
3111111111111111111111111111113
3111111111111111111111111111113
3111111111111111111111111111113
3111111111111111111111111111113
