3000000000000000000000000000000000000000000000000000000000000000000000000000000000000000000000000000000000000003
3000000000000000000000000000000000000000000000000000000000000000000000000000000000000000000000000000000000000003
3000000000000000000000000000000000000000000000000000000000000000000000000000000000000000000000000000000000000003
3000000000000000000000000000000000000000000000000000000000000000000000000000000000000000000000000000000000000003
3000000000000000000000000000000000000000000000000000000c0d000000000000000000000000000000000000000000000000000003
3000000000000000000000000000000000000000000000000000022222200000000000000000000000000000000000000000000000000003
3000000000000000000000000000000000000000000000000000000000000000000000000000000000000000000000000000000000000003
3000000000000j00000000000c000000t000000000000000t0000u0000000000t000000000000000s000000000000000c000000000000e03
3222222222222200000222222222222222222000222222222222222222222222222222222222222222222222222222222222222222222223
3111111111111100000111111111111111111000111111111111111111111111111111111111111111111111111111111111111111111113
3111111111111100000111111111111111111000111111111111111111111111111111111111111111111111111111111111111111111113
3111111111111100000111111111111111111000111111111111111111111111111111111111111111111111111111111111111111111113
3111111111111100000111111111111111111000111111111111111111111111111111111111111111111111111111111111111111111113
3111111111111100000111111111111111111000111111111111111111111111111111111111111111111111111111111111111111111113
