3000000000000000000000000000000000000000000000000000000000000000000000000000000000000000000000000000000000000003
3000000000000000000000000000000000000000000000000000000000000000000000000000000000000000000000000000000000000003
3000000000000000000000000000000000000000000000000000000000000000000000000000000000000000000000000000000000000003
300000000000c00000s000000000000000000000000000000000000000000000000000000000000000000000000000000000000000000003
30000000000000000020000000000000000d0000000000000000000000000000000000000000000000000000000000000000000000000003
30000000000000000u00000000000002222200000000000000000000000000000222222000000000000000000j0000000000000000000003
3000000000000000000000000j0000000000000000000000000000s0000000002000000000000000000000000000000j0000j00000000003
300000000000j000000000000000000000000000000j000000222220000020000000000000000000j0000j000000000000000000000e0003
3000000j00000000000000000000000c0000000000000000000000000000000000000000000j000000000000000000000000000002222223
31111111000000000000000000000000022200j00000000000000000000000000000000000000000000000000000c0000000000001111113
3111111100000000000000000000000j000000000000000000000000000000000000000000000000000000000000j0000000000001111113
3111111100000000000000000000000000000000000000000000000000000000000000000000000000000000000000000000000001111113
3111111100000000000000000000000000000000000000000000000000000000000000000000000000000000000000000000000001111113
3111111100000000000000000000000000000000000000000000000000000000000000000000000000000000000000000000000001111113