3000000000000000100000000000000000000001000000000000000000100000000000000000000000000000000000000000000000000003
300c000000t000d0100000000000000000000001000000000000000d00100000000000000t00000000t000000000t0d00000000000000003
3222222222222222211111111111111111111111222222200002222222222222222222222222222222222222222222222222222222222223
3000000010000001000000000000000000000000100000000003010000000000100000000000000000000000100000000000000000000003
3d00000u1d000001000000000000000000000000100u000000030100000d00001000u00000t000000t0000001000000d0000000000000003
3222222222222222222222222222222222222222222222200002222222222222222222222222222222222222222222222222222222222223
3000000100000000000000000000000000000000100000300003010000000000000010000000000000000000000000000000000000000003
300000u100000000000000000d00000t00t00t001u0000300003010000000000000u1000000000000000000000000000c00000s000000e03
3222222222222222222222222222222222222222222222200002222222222222222222222222222222222222222222222222222222222223
3111111111111111111111110000000000000000000011100001111111111111111111111111111111111111111111111111111111111113
3111111111111111111111110000000000000c0000u011100001111111111111111111111111111111111111111111111111111111111113
3111111111111111111111111111111111111111111111100001111111111111111111111111111111111111111111111111111111111113
3111111111111111111111111111111111111111111111100001111111111111111111111111111111111111111111111111111111111113
3111111111111111111111111111111111111111111111100001111111111111111111111111111111111111111111111111111111111113
