0000000000000000000000000000000000000000000000000000000000000000000000000000000000000000000000000000000000000000
0000000000000000000000000000000000000000000000000000000000000000000000000000000000000000000000000000000000000000
0000000000000000000000000000000000000000000000000000000000000000000000000000000000000000000000000000000000000000
0000000000000000000000000000000000000000000000000000000000000000000000000000000000000000000000000000000000000000
0000000ccccc0000000000000000000000000000000000000000022222000200000000000000000000000000000000000000000000000000
0000000000000000000000000000000000000000000200000222200000000022222200000000000000000000000000000000000000000000
0000000222220000000000000000000000000000000022222000000000000000000000000000000000000000000000000000000000000000
0000000000000000000000000000000000000000000000000000000000000000000000000000000000000000000000000000000000000000
220j000000000000022000000220002222222222222222222222222222222222222222222222222222222222222222222222222220000000
1122222222222222211000022112001111111111111111111111111111111111111111111111111111111111111111111111111111111100
1111111111111111111000011111001111111111111111111111111111111111111111111111111111111111111111111111111111111110
1111111111111111111000001100001111111111111111111111111111111111111111111111111111111111111111111111111111111110
1111111111111111111000001000001111111111111111111111111111111111111111111111111111111111111111111111111111111110
1111111111111111111000001000001111111111111111111111111111111111111111111111111111111111111111111111111111111110