3000000000000000000000000000000000000000000000000000000000000000000000000000000000000000000000000000000000000003
3000000000000000000000000000000000000000000000000000000000000000000000000000000000000000000000000000000000000003
30000000s00000000000c0000000000000000000000000000000000000000000000000000000000000000000000000000000000000000003
3000002220000002000020000200000000002000000000000000000000000000000000000000000000000000000000000000000000000003
3000020000000000000000000000000j000000000000000000000000c0222000000000000000000000000000000000000000000000000003
3000200000000000000000000000000200000000000000000002222222200000000000000000000000000000000000000000000000000003
3002000000000000000000000000000000000000000000000000000000000000000000000000000000000000000000000000000000000003
302000000000000000000000000000000000000003000000r00000u000000000r000000r0000000r000000r00000r00000r00000c0000e03
3200000000000000000000000000000000000000002222222222222222222222222222222222222222222222222222222222222222222223
3100000000000000000000000000000000000000001111111111111111111111111111111111111111111111111111111111111111111113
3100000000000000000000000000000000000000001111111111111111111111111111111111111111111111111111111111111111111113
3100000000000000000000000000000000000000001111111111111111111111111111111111111111111111111111111111111111111113
3100000000000000000000000000000000000000001111111111111111111111111111111111111111111111111111111111111111111113
3100000000000000000000000000000000000000001111111111111111111111111111111111111111111111111111111111111111111113
