3000000000000000000000000000000000000000000000000000000000000000000000000000000000000000000000000000000000000003
3000000000000000000000000000002000000000000000000000000000000000000000000000000000000000000000000000000000000003
300r000000r000000000000r00cj0020000000000000000000000000000000000r0r00000000000000000000000000000000000000000003
3222222222222222222222222222002000000000000000000000000000000022222222000000000000000000000000000000000000000003
3000000000000000000000000000002000000000000000000000000000000c00000000000000c00000000000000000000000000000000003
3000000000000000000000000000002000000000000000000000000000000000000000000000000000000000000000000000000000000003
3000000000000000000000000000002000000000000000000000000000000000000000000000000000000000000000000000000000000003
3000000000r000000r00000r00000j20s000000000r0000r0000r00000j0000000000000000j0000000000000r0000r00r00r00r000e0003
3222222222222222222222222222222222222222222222222222222222222222222222222222000000022222222222222222222222222223
3111111111111111111111111111111111111111111111111111111111111111111111111111000000211111111111111111111111111113
3111111111111111111111111111111111111111111111111111111111111111111111111111000000011111111111111111111111111113
3111111111111111111111111111111111111111111111111111111111111111111111111111000000011111111111111111111111111113
3111111111111111111111111111111111111111111111111111111111111111111111111111000000011111111111111111111111111113
3111111111111111111111111111111111111111111111111111111111111111111111111111000000011111111111111111111111111113