3000000000000000000000000000000000000000000000000000000000000000000000000000000000000000000000000000000000000003
30000000000000000c00000000000000000000000000000000000c0000000000000000000000000000000000000000000000000000000003
3011111111111111010000000000000000000000000000000000010000000000000000000000000000000000000000000000000000000003
3000000000000000j10000000000000000000000000000000000j10000000000000000000000000000000000000000000000000000000003
3000000000000000010000000000000000000000000000000000010000000000000000000000000000000000000000000000000000000003
3000000000000000010000000000000000000000000000000000010000000000000000000000000000000000000000000000000000000003
3000000000000000010000000000000000000000000000000000010000000000000000000000000000000000000000000000000000000003
300r0000r0000r00j1000r00000r0000r0000000r00000000r00j10000r000000r000r00000000r0000000r00000000r000000r000c00e03
3222222222222222222222222222222222222222222222222222222222222222222222222222222222222222222222222222222222222223
3111111111111111111111111111111111111111111111111111111111111111111111111111111111111111111111111111111111111113
3111111111111111111111111111111111111111111111111111111111111111111111111111111111111111111111111111111111111113
3111111111111111111111111111111111111111111111111111111111111111111111111111111111111111111111111111111111111113
3111111111111111111111111111111111111111111111111111111111111111111111111111111111111111111111111111111111111113
3111111111111111111111111111111111111111111111111111111111111111111111111111111111111111111111111111111111111113
