300000000000000000c200000000000000000000000000000000000000000000020000000000000000000000000000000000000000000003
3000000000000000000200000000000000000000000000000000000000000000020000000000000000000000000000000000000000000003
3000000000000000000200000000000000000000000000000000000000000000020000000000000000000000000000000000000000000003
300000000000000000020000000002222220000000000000000000000000000002000000000000000000000c000000000000000000000003
30000000000r00r00rd200000000000020000000000000000000000000000000020000000000s00000000000000000000000000000000003
3000000022222222222000000000000020000000000000000000000000000000022222222222200000000000000000000000000000000003
3000000000000000000000000000000020000000000000000000000000000000000000000000200000000000000000000000000000000003
300000000000000000s0000r00jr00r02000000000r0s00r00j00000000000000000ru000r002000r000r00r0000r0000r000r000000e003
3222222200000000022222222222222220000022222222222220000000000222222222222222222222222222222222222222222222222223
31111111000000000111111111111111000c0011111111111110000000000111111111111111111111111111111111111111111111111113
31111111000000000111111111111111000j0011111111111110000000000111111111111111111111111111111111111111111111111113
3111111100000000011111111111111100000011111111111110000000000111111111111111111111111111111111111111111111111113
3111111100000000011111111111111100000011111111111110000000000111111111111111111111111111111111111111111111111113
3111111100000000011111111111111100000011111111111110000000000111111111111111111111111111111111111111111111111113
